










            1              1           1             1                 1               1                           
         1         1     1      1    1     1      1     1     1     1         1    1      1    1     1
               1     1     1            1      1    1                    1            1     1     1      1   
         7  1      1      1     1     1     1      1   1  1 1    1 1   1    1  1    1     1     1      1              1
11111111111111111111111111111111111111111111111111111111111111111111111111111111111111111111111111111111111111  1111111111111111111111
11111111111111111111111111111111111111111111111111111111111111111111111111111111111111111111111111111111111111  1111111111111111111111
11111111111111111111111111111111111111111111111111111111111111111111111111111111111111111111111111111111111111  1111111111111111111111
