










                11111111111                  1111
              1111111111111               1  111111111
 
111111111111111111111111111       1    11111111111111111    1  1      1     1111111111111111111111111  
111111111111111111111111111            11111111111111111                     111111111111111111111111 
111111111111111111111111111            11111111111111111                     111111111111111111111111 



                                11111111111111111111  11111   11   11   11  11  11    11  1 111 1 11
