


























                                               1 
                                               1 
                                               1 
                                       1       1       
                                 1             
                                                     11                         111      1
                                       1    1111111  1111                111    111      1
                                 1     1     1   1   111111    1     1   111    111      1
                                 1 111 1222221   1   11111111  1 111 1   111    111      13333     333
1111111111111111111111111111111111111111111111111111111111111111111111111111111111111111111111111111111111111111111111111111111111111111111111111111111111111111111111111111111111111111111
1111111111111111111111111111111111111111111111111111111111111111111111111111111111111111111111111111111111111111111111111111111111111111111111111111111111111111111111111111111111111111111
1111111111111111111111111111111111111111111111111111111111111111111111111111111111111111111111111111111111111111111111111111111111111111111111111111111111111111111111111111111111111111111
